1111111111111111111111111111111111111111111111111111111111111111111111111110001111111111111111111111
1111111111111111111111111111111111111111111111111111111111111111111111111000000111111111111111111111
1111111111111110001111111111111111111111111111110111100111111111111111110000000111111111111110000111
1111111111111100001111111111111111111111111111100011000000111111111111100000001111111111111100000011
1111111111110000011111111111111111111111111111100011100000011111111111100000001111110111111100000011
1111101111100011111111111111111111111111111111100011110000011111000111100000011111111111111000100111
1111001111000011111111111111111111111111111111100011100111111111000111100001111111111111110001111111
1110011111000111111111111111111111111111111111000111100111111110001111110011111111111111110001111111
1110011100001111111111111111111111111111100111001111100011111110011111111111000111111111111000111111
1100011000011111111111001111111111111111000010001111110011111111111111111111000111111111111100011111
1100000000011111111110000111111111111111100000001111111011111111111111001111100011111111111110001111
1110000000011111111110000011111111111111110000001111111111111111111110000111000001111111111111001111
1111110000011111111100110001111111111111111000001111111111111111111000000111000001111111111111001111
1111111000011111111000110001001111111111111111001111001111111111110000001111100001111110001110001111
1111111100001111111000000010000110011111111111000000011111111111110000011111110001111110001100001111
1111111110001111111000001111000000001111111111000000111111111111111001111111110001111110011110011111
1111111111001111111100001111100000011111111111000000111111111111111111111111100000011111111111111111
1111111111101111111110001111110001111111111111000000001111111111111111111111100000001111111111111111
1111111111000111111100001111111011111111111111100000000111111111111111111111110000000111111111111111
1111111111101111110000011111110011111111111111111000000111111111111111111111111110000011111111111111
1111111111111111100000011111100001111111111111111100000111111111111111111111111111000001111111111111
1111111111111111100000111111100011011111000001111100000111111111111111111111111111000000111111111111
1111111111111111110001111111001111001110000000011000001111111111111111111000111111100000111111110011
1111111111111111111011111111001111011100000000000011111111111111111111110000011111110001111100110011
1111111111111110011101111111001110011100000000000111111111111111111111100000001111111111111000000011
1111111111111100001000001111100000001000000000011111111111111111111111000000000001111111110000000011
1111111111111000000000000111110000010000000000011111111111111111111111000000110000111111110000001111
1111111111000000000000000111110000111001100000001111111111111111111111100000110000011111110000011111
1111001110000000001100000011110000010011110000001111111111111111111111110000011000011111111000011111
1110000000000000011110000011111000000011111000011111111111111111111111110000011110111111111100011111
1110000000000000011110000111111111100111111100111111100111111111111111111000111111111111111110011111
1111000000000000001110011111111111111111111111111111000011111111111111111111111111111111111110000001
1110000000001000000100111100001111111111111111111111000011111111111110001111111111111111111110000000
1100000000011100000000110000000111111111000111111111000011111111111100000111111111111111111111000000
1000011000111100000000000000000111111110000011111111100011111111111100000011111111100011111111100001
1000011111111100000000000000001111111110011000111111100001111111110000000011111111000011111110011111
1000001111111110011110000000011111111110011000111111100000111111000000000011000111000011111100001111
1000000111111110011111111111111111111110011100111111000000011110000010000011000011000111111100000111
1100000111111111111111111111111111111100011111111111000000000001000111000011100000000011111110000011
1000001111001111111111111111111111111000111111111111100001110001111111100011100000000001111111100011
0000011110000111111111111111111111110000011111111111110001111001111111100011100001000001111111100111
0000001110000111111111111111111111100100011111111111111011111001111111100011100011100001111111100111
0000000110001111111110111111111111111110111111111111111001111000011111100001000011100001111111100111
1001000000011111111000011111111111111100111111110001111000000000001111100000000011000011111111100011
1011100011111111110000111111111111111100011111110000111100000000001111000000000000000011111111100001
0001111111111111110001111111111111111100001111110000111111100000011110000000000000000011111111110001
0000111111111111100011111111111111111110001111110001111111111001111110000000011111000011111111111001
1001111111111111000011111111111111111110001111110001111111111111111111000001111111000111111111111001
1111111111111110000001111111111111111111111111111000111111111111111111111111111111101111111111111101
1111111111111110000001111111111111111111111111110000111100011111111111111111111111111111111111111001
1111111111111110000011111111111111111111111111110000111100011111111111111111111111111111111111100001
1111111111111100000011111111111111111111111111111001111100011111111111111111100011111111111111000001
1111111111111000000011111111111111111111111111111111110000011111111111111110000001111111111111000001
1111111111110000000111111111111111111111111111111111100000111111111111111100000001111111111111000001
1111111111000000011111111111111111111111111111111111100001111111111111111110110001111111111100000000
1111111110000000011100111111111111111111111111111111110011111111111111111111110001111111111000011000
1110111110000100111000011111111111111111111111000111111111111111111111111111100011110001111000111000
1100011111001111111000011111111111111101111110000011111111110000111111111111000001110001111000110000
1100011111111111111000011111111111111100011110000011111111100000011111111110000000000011111000000000
1110011111111111111100111111111111111100011111000111111111000000011111111110000010000011110000000001
1111111111111111111111111111111111111001111111111111111111000000011111111111000111100111110000001111
1111111111111111111111111111111111100001111111111111111111000000111111111111001111100111110000011111
1111111111111111111110011111111111000001111111111111111111100111111111111111100111100011100011111111
1111111111110001111000001111111111000001110011111111111111111111111111111111100111110000000011111001
1111111111111011110000001111111111000001100001111111111111111111111111111111100011111000000001111001
1111111111111111110000001111111111100001100011111111111111111001111111111111110000111001110011111111
1111111111111111110000001111111111110000000111111111111111110000001111111111111000000001111111111111
1111111110011111110011000001111111110000000111111111111111000000000111111111111000000011111111111111
1111110000001111110011100000111111110000000111111111111110000000000111100111111100001111111111111111
1111100000001111100001100000111111111000001111111111100000000111100011000001111111111111111111111111
1111000000000111000001100000111111111111111111111111000000001111110000000000111111111111111111111111
1111101111100111000011110001111111111111111111111110000001111111110000000001111111111111111111111111
1111111111100011100011111111111111111111111111111110000001111111111000000011111111111111111111111111
1111111111100011110001111111111111111111111111111111000001111111111001100011111111111111001110011111
1111111111110111111001111111001111111111111001111111110000111111111001100001111111111110000111001111
1111111111111111111000001110000110111111111001111111111000111111110000000001111111111110000010001111
1111111111111111111000000100000000111111111100111111111100111111100000000011111111111110000000000111
1111100111111111111100000000000000111111111000111111111100011111000000000111111111110000001100000111
1111000011111111111111000000000000111111111000111111111100001111000000000111111110000000001100000111
1111000011111111111111100001110001110111111000111111111100001111100000000011111100000000000000001111
1111100111111111111111110011111111100011111000111111111110011111000111100111111000000000000000011111
1111111111111111111111110011111111000011111100011111111111111111000111111111110000000111111111111111
1111111111111111111111110001111111000011111110001111100111111111000111111111110000000111111111111111
1111111111111111111111110000111111100111111111000111000011111111000111111111111000000011111111111111
1101111111111111111111110000111111111111111111000110000011111111101111111111111111110011111111111111
1000111111111111111111100000111111111111111110000110000111111111111111111111111111110001111111111111
1000001111111111111110000001111111111111111110000000000011111111111111111111111111110000001111111001
1000000111111111111100000111111111111111111110000000000011111111111111111111111111110000000111111001
1000000011001111111100000111111111111111111111000111100000000111111111111111111111110000001111111101
1100000000000100010000001111111111011111111111111111100000000011111111111111111111110000000111111001
1000000110000000000000011111111110000111111111111111100001100001111111111111111111110000000111100001
1000011111100000000000011111111110000011111111111111100001100000111111111111111111100000001111000011
1100111111111110001110011111111110000011111111110011100001110000111111111111111111100011111111000011
1111111111111111111110011111111000000111111111100001110011111110011111111111111111110011110011000001
1111111111111111111100011110000001100111111111100001111111111111111111111111111111111000000001100001
1111111111111111111110111110000001100111111111000001111111111111111111111111111111111100000001110001
1111111111111111111111111111000001111111111110000011111111111111111110011111111111111110000000110001
1111111111111111111111111111000001111111111100000011111111111111111110001111111110111111000000000001
1111111111111111111111111111100011111111111110011111111111111111111110011111111111111111100000000011
1111111111111111111111111111111111111111111111111111111111111111111111111111111111111111111100111111
