11111111111111111111111111100110011111111111111111
11111111111111110011111111000000001111111111111111
11111111111111100001111111000000000111111111111111
11111111111111100001111111100000000011111001111111
11111111111111000001111111000000000001100000111111
11111111111110000011111111000000000000000000111111
11111111111100000111111111000001111100000001111111
11111111110000000011111111100011111100110011111111
11111111100000000011100111100111111000111111111111
11111111000000000001000111100011111001111111111111
11111111011000000000000111110111100001111111111111
11111111111100000000001111111111000000111111111111
11000111111100000000001111111110000000111111111111
11000001111100000000000111111100000000111111111111
11000000111110000000000011111000111111011111001111
11100000011111100110000011111101111110001110000111
11110000001111100110000111111111111110000000000011
11111110000000001111000111111111000100001000000011
11111110000000001111000111111111000000011100000011
11111100001110001111000001111111000000011100000011
11111100001111111111100000111111100000111100000111
11111110001111111111110000111111100001111110001111
11111111001111111111111000110011100011111111111111
11111110001111111111110000000001100111111111111111
11110000001111111111100000011100000011111111111111
11100000001111111001100001111110000011111111111111
11100000011111110000011111111110000111111111100011
11100000011111110000011111111111001111111111100001
11111100001111111000111111111111111111111111110001
11111111001111111111111111111111111111111011111011
11111111100111111111111111111111111111110001111111
11000001000111111111111111111111111111111000111111
11000000000111100001111111111111111111111100011111
11001100001111100001111111111111111111111110001111
11111100001111110001111111111111111110001110001111
11111000001111111111111111111111111100000110001111
11110000011111111111111111111111111100000111011111
11110000111111111111111111111111111110001111111111
11111001111111111111111111111111111111111111111111
11111111111111111111111111111111111111111111111111
11111111101111111111111111111111111111111111111111
11111110000111111111111111111111111111111111111111
10111100001111111111111111111111111111111111111111
00011100011111111111111111111111111111111111000111
00000000111111111111111111111111111111111110000011
00000001111111111111111111111111111111110000000011
10011000111111111111111111111111111111100000000011
11111000111111111111111111110111111111100000000111
11111000111111111111111111110111111111100000111111
11111101111111111111111111111111111111110001111111
