11111111111111111111111111111111111111111111111111
11111111111111111111111111111111111111111111111111
11111111111111111111111111111001111111111111111111
11111111100011111111111001110000111111111111111111
11111111000011111111010000100000111111111111111111
11111111000111111111000010000001111111111111011111
11111111000111111110000111000111100111111110001111
11111111000011111110000011100111000011111100011111
11111111100000110000000001000000000011111100111111
11111111110000000000000000000000000011111000111111
11111111111111000000011000001100000111000000111111
11111111111111111100011000001110000110000000011111
11000111111111111100011100001111000110001100011111
10000111111111111100111100011111100000001110011111
10000011111111111001111100111111100000001110001111
11000001111111000001111000111111000000001110000011
11110000111111000011111101111110000000001111000001
11110000111110000011111111111100000000011111000001
11110001111110000001111111111100000000001111100011
11110011111110000001111111111110000000000111111111
11111111111100000011111111111111000000000011111111
11111111111000000111111100000010001110000011111111
11111111111000000111111000000000011111100111110011
11111111111000000111100000001000111111111001100001
11111111111100000111000000011100011111111000010001
11111111111110000011000000111110111111111000011001
11110011111111110000000000011111111111111100110001
11100001111111110000100000011111111101111111100001
11100000111111110001110000011111111000111111100001
11110000011111100001110000001111111000111111110011
11110000011111100001100000001111111000111111111111
11100000011111000011100000000110000001111111111111
11000000011111000001100000000000000001111111111111
10000000001111000001100000000000000011111111111111
00000100000111100001100000110000000111111111111111
00001110000111110011110001110000011111111111111111
00001111001111111111111111100000111100011111111111
10011111111111111111111111000001111000001111111111
11111111111111111111111110000001111000001111111111
11111111111110001000111100000011111000011111111111
11111111111100000000001000000111111000111111111111
11111111111100000000000000000111111000111111111111
11111111111100000000000000000111111111111111111111
11111111111100000000000000001111111111111111111111
11111111111100000011000000001111111111111111111111
11111111111100000011000000001111111111111111111111
11111111111100000000001000011111111111111111001111
11111111111110000000011100111111110111111110000111
11111111111111000000111111111111111111111110000111
11111111111111111111111111111111111111111111001111
